C 255,255,255
F 100,113,221

NO E_tex.xpm
SO E_tex.xpm
WE E_tex.xpm
EA E_tex.xpm

1111111111111111111111111111111
1                             1
1                             1
1                             1
1                             1
1                             1
1                             1
1                             1
1                             1
1                             1
1                             1
1                             1
1                             1
1                             1
1                             1
1                             1
1                             1
1                             1
1                             1
1                             1
1                             1
1111111111111111111111111111111