C 255,255,255
F 0,0,0

NO N_tex.xpm
SO E_tex.xpm
WE E_tex.xpm
EA E_tex.xpm

1111111111111111111111111111111
1               N             1
1111111111111111111111111111111