C 28,0,154
F 91,193,60

NO ./textures/wall.xpm
SO ./textures/wall.xpm
WE ./textures/wall.xpm
EA ./textures/wall.xpm

1111111111111111111111111111111
1       0 1    0W1            1
1       0 111D1111            1
1       0                     1
1       0                     1
1       0                     1
1       0                     1
1       0                     1
1       0                     1
1111111111111111111111111111111